Gene Symbol	Name
ARHGEF12	RHO guanine nucleotide exchange factor (GEF) 12 (LARG)
ATM	ataxia telangiectasia mutated
BCL9L	B-cell CLL/lymphoma 9-like
BIRC3	baculoviral IAP repeat-containing 3
CBL	Cas-Br-M (murine) ecotropic retroviral transforming
CCND1	cyclin D1
DDX10	DEAD (Asp-Glu-Ala-Asp) box polypeptide 10
DDX6	DEAD (Asp-Glu-Ala-Asp) box polypeptide 6
FLI1	Friend leukemia virus integration 1
KCNJ5	potassium inwardly-rectifying channel; subfamily J; member 5
KMT2A	lysine (K)-specific methyltransferase 2A
MAML2	mastermind-like 2 (Drosophila)
MEN1	multiple endocrine neoplasia type 1 gene
NUMA1	nuclear mitotic apparatus protein 1
PAFAH1B2	platelet-activating factor acetylhydrolase, isoform Ib, beta subunit 30kDa
PICALM	phosphatidylinositol binding clathrin assembly protein (CALM)
POU2AF1	POU domain, class 2, associating factor 1 (OBF1)
SDHAF2	succinate dehydrogenase complex assembly factor 2
SDHD	succinate dehydrogenase complex, subunit D, integral membrane protein
ZBTB16	zinc finger and BTB domain containing 16
