Gene Symbol	Name
ABL2	c-abl oncogene 2, non-receptor tyrosine kinase
ARNT	aryl hydrocarbon receptor nuclear translocator
BCL9	B-cell CLL/lymphoma 9
CDC73	cell division cycle 73
DDR2	discoidin domain receptor 2
ELK4	ELK4, ETS-domain protein (SRF accessory protein 1)
FCGR2B	Fc fragment of IgG, low affinity IIb, receptor for (CD32)
FCRL4	Fc receptor-like 4
FH	fumarate hydratase
H3F3A	H3 histone, family 3A
LMNA	lamin A/C
MDM4	Mdm4 p53 binding protein homolog
MLLT11	myeloid/lymphoid or mixed-lineage leukemia (trithorax homolog, Drosophila); translocated to, 11
MUC1	mucin 1, transmembrane
NTRK1	neurotrophic tyrosine kinase, receptor, type 1
PBX1	pre-B-cell leukemia transcription factor 1
PDE4DIP	phosphodiesterase 4D interacting protein (myomegalin)
PRCC	papillary renal cell carcinoma (translocation-associated)
PRRX1	paired related homeobox 1
PTPRC	protein tyrosine phosphatase, receptor type, C
SDHC	succinate dehydrogenase complex, subunit C, integral membrane protein, 15kDa
SLC45A3	solute carrier family 45, member 3
TPM3	tropomyosin 3
TPR	translocated promoter region
