Gene Symbol	Name
ARID2	AT rich interactive domain 2
ATF1	activating transcription factor 1
BCL7A	B-cell CLL/lymphoma 7A
BTG1	B-cell translocation gene 1, anti-proliferative
CDK4	cyclin-dependent kinase 4
CLIP1	CAP-GLY domain containing linker protein 1
COL2A1	collagen, type II, alpha 1
DDIT3	DNA-damage-inducible transcript 3
ERBB3	erb-b2 receptor tyrosine kinase 3
HMGA2	high mobility group AT-hook 2 (HMGIC)
HNF1A	HNF1 homeobox A
HOXC11	homeo box C11
HOXC13	homeo box C13
KMT2D	lysine (K)-specific methyltransferase 2D
LRIG3	leucine-rich repeats and immunoglobulin-like domains 3
MDM2	Mdm2 p53 binding protein homolog
NAB2	NGFI-A binding protein 2
NCOR2	nuclear receptor corepressor 2
POLE	polymerase (DNA directed), epsilon, catalytic subunit
PTPN11	protein tyrosine phosphatase, non-receptor type 11
PTPRB	protein tyrosine phosphatase, receptor type, B
SH2B3	SH2B adaptor protein 3
SMARCD1	SWI/SNF related, matrix associated, actin dependent regulator of chromatin, subfamily d, member 1
STAT6	signal transducer and activator of transcription 6, interleukin-4 induced
TBX3	T-box 3
WIF1	WNT inhibitory factor 1
