Gene Symbol	Name
ARID1A	AT rich interactive domain 1A (SWI-like)
ATP1A1	ATPase, Na+/K+ transporting, alpha 1 polypeptide
BCL10	B-cell CLL/lymphoma 10
CAMTA1	calmodulin binding transcription activator 1
CDKN2C	cyclin-dependent kinase inhibitor 2C (p18, inhibits CDK4)
CSF3R	colony stimulating factor 3 receptor (granulocyte)
EPS15	epidermal growth factor receptor pathway substrate 15 (AF1p)
FUBP1	far upstream element (FUSE) binding protein 1
JAK1	Janus kinase 1
JUN	jun oncogene
LCK	lymphocyte-specific protein tyrosine kinase
MPL	myeloproliferative leukaemia virus oncogene, thrombopoietin receptor
MTOR	mechanistic target of rapamycin
MUTYH	mutY homolog (E. coli)
MYCL	v-myc avian myelocytomatosis viral oncogene lung carcinoma derived homolog
NOTCH2	Notch homolog 2
NRAS	neuroblastoma RAS viral (v-ras) oncogene homolog
PAX7	paired box gene 7
PRDM16	PR domain containing 16
RBM15	RNA binding motif protein 15
RPL22	ribosomal protein L22 (EAP)
RPL5	ribososomal protein L5
SDHB	succinate dehydrogenase complex, subunit B, iron sulfur (Ip)
SFPQ	splicing factor proline/glutamine rich(polypyrimidine tract binding protein associated)
SPEN	spen family transcriptional repressor
STIL	SCL/TAL1 interrupting locus
TAL1	T-cell acute lymphocytic leukemia 1 (SCL)
TENT5C	family with sequence similarity 46, member C
TNFRSF14	tumor necrosis factor receptor superfamily, member 14 (herpesvirus entry mediator)
TRIM33	tripartite motif-containing 33 (PTC7,TIF1G)
