Gene Symbol	Name
ASPSCR1	alveolar soft part sarcoma chromosome region, candidate 1
AXIN2	axin 2
BRCA1	familial breast/ovarian cancer gene 1
BRIP1	BRCA1 interacting protein C-terminal helicase 1
CANT1	calcium activated nucleotidase 1
CD79B	CD79b molecule, immunoglobulin-associated beta
CDK12	cyclin-dependent kinase 12
CLTC	clathrin, heavy polypeptide (Hc)
COL1A1	collagen, type I, alpha 1
DDX5	DEAD (Asp-Glu-Ala-Asp) box polypeptide 5
ERBB2	v-erb-b2 erythroblastic leukemia viral oncogene homolog 2, neuro/glioblastoma derived oncogene homolog (avian)
ETV4	ets variant gene 4 (E1A enhancer binding protein, E1AF)
H3F3B	H3 histone, family 3B (H3.3B)
HLF	hepatic leukemia factor
LASP1	LIM and SH3 protein 1
MLLT6	myeloid/lymphoid or mixed-lineage leukemia (trithorax homolog, Drosophila); translocated to, 6 (AF17)
MSI2	musashi homolog 2 (Drosophila)
NF1	neurofibromatosis type 1 gene
PPM1D	protein phosphatase, Mg2+/Mn2+ dependent 1D
PRKAR1A	protein kinase, cAMP-dependent, regulatory, type I, alpha (tissue specific extinguisher 1)
RARA	retinoic acid receptor, alpha
RNF213	ring finger protein 213
RNF43	ring finger protein 43
SMARCE1	SWI/SNF related, matrix associated, actin dependent regulator of chromatin, subfamily e, member 1
SPOP	speckle type POZ protein
SRSF2	serine/arginine-rich splicing factor 2
STAT3	signal transducer and activator of transcription 3 (acute-phase response factor)
STAT5B	signal transducer and activator of transcription 5B
SUZ12	suppressor of zeste 12 homolog (Drosophila)
TAF15	TAF15 RNA polymerase II, TATA box binding protein (TBP)-associated factor, 68kDa
