Gene Symbol	Name
BRD4	bromodomain containing 4
CALR	calreticulin
CRTC1	CREB regulated transcription coactivator 1
DNAJB1	DnaJ heat shock protein family (Hsp40) member B1
DNM2	dynamin 2
ELL	ELL gene (11-19 lysine-rich leukemia gene)
FSTL3	follistatin-like 3 (secreted glycoprotein)
GNA11	guanine nucleotide binding protein (G protein), alpha 11 (Gq class)
JAK3	Janus kinase 3
KEAP1	kelch like ECH associated protein 1
LYL1	lymphoblastic leukemia derived sequence 1
MAP2K2	mitogen-activated protein kinase kinase 2
MLLT1	myeloid/lymphoid or mixed-lineage leukemia (trithorax homolog, Drosophila); translocated to, 1 (ENL)
PRKACA	protein kinase cAMP-activated catalytic subunit alpha
SH3GL1	SH3-domain GRB2-like 1 (EEN)
SMARCA4	SWI/SNF related, matrix associated, actin dependent regulator of chromatin, subfamily a, member 4
STK11	serine/threonine kinase 11 gene (LKB1)
TCF3	transcription factor 3 (E2A immunoglobulin enhancer binding factors E12/E47)
TPM4	tropomyosin 4
