Gene Symbol	Name
ATR	ATR serine/threonine kinase
BCL6	B-cell CLL/lymphoma 6
CBLB	Cas-Br-M (murine) ecotropic retroviral transforming sequence b
CNBP	CCHC-type zinc finger, nucleic acid binding protein
EIF4A2	eukaryotic translation initiation factor 4A, isoform 2
ETV5	ets variant gene 5
FOXL2	forkhead box L2
GATA2	GATA binding protein 2
LPP	LIM domain containing preferred translocation partner in lipoma
MAP3K13	mitogen-activated protein kinase kinase kinase 13
MECOM	MDS1 and EVI1 complex locus
MLF1	myeloid leukemia factor 1
PIK3CA	phosphoinositide-3-kinase, catalytic, alpha polypeptide
PIK3CB	phosphatidylinositol-4,5-bisphosphate 3-kinase catalytic subunit beta
POLQ	DNA polymerase theta
RPN1	ribophorin I
SOX2	SRY (sex determining region Y)-box 2
TBL1XR1	transducin (beta)-like 1 X-linked receptor 1
TFG	TRK-fused gene
TP63	tumor protein p63
WWTR1	WW domain containing transcription regulator 1
